wwwwwww
w111111111w
w11111w
w11p11w
w11111w
w11111w
www1www
www1www
www1www
www1www
www1www
